**************************************************
**     *****************            **********   *
** * *                   *** ** * *            * *
** * * ** * **************************************
** * * ** *       ****                          **
** **************    * ** ******** ************ **
** **        *    **** ** *   **** ********     **
** ** ****** ****    * ** *** *           ***** **
*  ** **     **** **** **     * * ******* **    **
* *** ******      **** ** ***** * *     * ***** **
* *** ****** ********* **    ** * ***** *       **
*   *                  ***** ** *       **********
* ********************     * ** ************* ****
*               ** ********* **                   
** ** ** ** *** **           ***** *** * ** ** ***
*************** **** ******* ********* ***********
*************** **********************************
**************************************************